1111111111
1C000110C1
100111C1C1
10011011C1
1CE0000P01
1111111111